###############################
#------**-*----*---*--*-*-*---#
#-#-#-#*#-#-#*#*#-#-#-#*#*#*#-#
#---*-----***--*-1----*---*-*-#
#-#-#-#-#-#*#-#-#*#*#-#-#-#-#*#
#------------**--*--*---------#
#-#-#-#-#-#-#-#-#-#*#-#*#-#-#-#
#*--*---1--*--*-1----*--------#
#-#-#-#-#*#-#-#-#*#*#-#-#-#-#-#
#*----**--*-------*--p----2---#
#-#*#-#-#-#-#-#-#*#-#-#-#-#-#-#
#-----------*---*--*----------#
###############################