###############################
#------**-*----*---*--*-*-*---#
#-#-#-#*#-#-#*#*#-#-#-#*#*#*#-#
#---*-----***--*--1---*---*-*-#
#-#-#-#-#-#*#-#-#*#*#-#-#-#-#*#
#----1-------**--*--*---1--2--#
#-#-#-#-#-#-#-#-#-#*#-#*#-#-#-#
#*--*------*--*--2---*----p---#
#-#-#-#-#*#-#-#-#*#*#-#-#-#-#-#
#*----**--*-------*------2----#
#-#*#-#-#-#-#-#-#*#-#-#-#-#-#-#
#------1----*---*--*---1------#
###############################